1211231211
1        1
4        3
1   121  1
2   1 1  4
1   131  1
4        5
1   131  1
5        1
1121121211