12111211111412111
1        1      1
4   11   1 2 1  2
1   1           1
1          1    5
11211    1 11   1
1        1      1
2  1     11111  3
1  1     1      1
14111121113114111 